здддбддддддддддддддддддддддддддддддддддд©
Ё : Ё                                   Ё
Ё   Ё                                   Ё
Ё дда                                   Ё
Ё                                       Ё
Ё                                       Ё
Ё                                       Ё
Ё                                       Ё
Ё                                       Ё
Ё                                       Ё
Ё                                       Ё
Ё                                       Ё
Ё                                       Ё
Ё                                       Ё
Ё                                       Ё
юддддддддддддддддддддддддддддддддддддддды